1111111111111111
1000000C000000P1
1P00000000000EE1
1111111111111111
