111111111111
1000C0000001
100000000001
100000000001
1P0000000001
111111111111
