111111111111
10000C000
100000000E01
10P000000001
111111111111
