000000000000
00000C000000
000000000E00
00P000000000
000000000000
