111111111111111111111111111111
111111111111111111111111111111
110000000000000011111000000001
110C00000000000011C11000000001
110000011111110000000001110001
111111111111110000000001110001
111111111111110001111111110001
1111111111111C0001111111110E01
111111111111110001111111111111
11111C111111110001111111111111
111110110000000001111111110001
111110000000000000000000000001
111100000000000C00000000000001
1110000000000000000000000C0001
110000000000000000000000000001
110P0000C001111111110101010101
110000000001111111110101010101
111000000001111111110101010101
11110000000111111111C1C1C1C1C1
111111111111111111111111111111
