111111111111111111111111111111111111111111111
11111111111C000000000000000000000CC1111C00111
11111111111C000000000000000C00000C11111100111
111111111111111111111110000000000111111100C11
1111111111111C1C1C1C1110000000000111111100C11
1111111P0000000000000000001111000000000000C11
1111111111111C1C1C1C1100001111000000000000111
11111111111111111111111000CC1101100C000010111
11111111111111111111111100111101100000001E111
111111111111111111111111111111111111111111111
